Configuration for Service Bus
Management Database SQL Instance	EPKZASTW0008
Enable SSL connection with SQL Server instance	False
Authentication	Windows Authentication
Management Database Name	SbManagementDB
Gateway Database SQL Instance	EPKZASTW0008
Enable SSL connection with SQL Server instance	False
Authentication	Windows Authentication
Gateway Database Name	SbGatewayDatabase
Message Container SQL Instance	EPKZASTW0008
Enable SSL connection with SQL Server instance	False
Authentication	Windows Authentication
Message Container Database Name	SBMessageContainer01
RunAs Account	Aizhuldyz_Gabbassova@MOSCOW
RunAs Password	***********
Certificate Generation Key	***********
Farm Certificate	Auto-generated
Encryption Certificate	Auto-generated
HTTPS Port	9355
TCP Port	9354
Message Broker Port	9356
Resource Provider HTTPS Port	9359
Amqp Port	5672
Amqps Port	5671
Internal Communication Port Range	9000 - 9004
Enable firewall rules on this computer	True
Administrators Group	BUILTIN\Administrators
Registering container databases	SBMessageContainer01 SBMessageContainer02 SBMessageContainer03
Creating Namespace	ServiceBusDefaultNamespace
Management Portal Admin User	adminUser
Management Portal Tenant User	tenantUser
